"filename", "language", "JSON", "Markdown", "JavaScript", "CSS", "HTML", "comment", "blank", "total"
"/home/a/Coding/materiom/portal/README.md", "Markdown", 0, 38, 0, 0, 0, 0, 33, 71
"/home/a/Coding/materiom/portal/package-lock.json", "JSON", 25697, 0, 0, 0, 0, 0, 1, 25698
"/home/a/Coding/materiom/portal/package.json", "JSON", 50, 0, 0, 0, 0, 0, 1, 51
"/home/a/Coding/materiom/portal/public/index.html", "HTML", 0, 0, 0, 0, 26, 23, 1, 50
"/home/a/Coding/materiom/portal/public/manifest.json", "JSON", 25, 0, 0, 0, 0, 0, 1, 26
"/home/a/Coding/materiom/portal/src/App.js", "JavaScript", 0, 0, 69, 0, 0, 15, 11, 95
"/home/a/Coding/materiom/portal/src/Components/AuthorTag.js", "JavaScript", 0, 0, 22, 0, 0, 0, 4, 26
"/home/a/Coding/materiom/portal/src/Components/DashboardListItem.js", "JavaScript", 0, 0, 19, 0, 0, 2, 2, 23
"/home/a/Coding/materiom/portal/src/Components/EditRecipeDetails.js", "JavaScript", 0, 0, 173, 0, 0, 3, 9, 185
"/home/a/Coding/materiom/portal/src/Components/EditRecipeListItem.js", "JavaScript", 0, 0, 25, 0, 0, 2, 3, 30
"/home/a/Coding/materiom/portal/src/Components/EditRecipeSideBar.js", "JavaScript", 0, 0, 71, 0, 0, 1, 2, 74
"/home/a/Coding/materiom/portal/src/Components/HelpBox.js", "JavaScript", 0, 0, 43, 0, 0, 1, 4, 48
"/home/a/Coding/materiom/portal/src/Components/Icon.js", "JavaScript", 0, 0, 12, 0, 0, 1, 1, 14
"/home/a/Coding/materiom/portal/src/Components/PrivateRoute.js", "JavaScript", 0, 0, 19, 0, 0, 3, 2, 24
"/home/a/Coding/materiom/portal/src/Components/RecipeTable.js", "JavaScript", 0, 0, 52, 0, 0, 4, 6, 62
"/home/a/Coding/materiom/portal/src/Components/RecipeTableRow.js", "JavaScript", 0, 0, 58, 0, 0, 2, 3, 63
"/home/a/Coding/materiom/portal/src/Components/SideBar.js", "JavaScript", 0, 0, 39, 0, 0, 1, 2, 42
"/home/a/Coding/materiom/portal/src/Data/index.js", "JavaScript", 0, 0, 187, 0, 0, 0, 1, 188
"/home/a/Coding/materiom/portal/src/Hooks/ChangeRoute.js", "JavaScript", 0, 0, 9, 0, 0, 2, 3, 14
"/home/a/Coding/materiom/portal/src/Hooks/ForceUpdate.js", "JavaScript", 0, 0, 5, 0, 0, 0, 1, 6
"/home/a/Coding/materiom/portal/src/Hooks/UpdateTitle.js", "JavaScript", 0, 0, 7, 0, 0, 1, 4, 12
"/home/a/Coding/materiom/portal/src/Hooks/UserContext.js", "JavaScript", 0, 0, 3, 0, 0, 1, 2, 6
"/home/a/Coding/materiom/portal/src/Hooks/clientUtils.js", "JavaScript", 0, 0, 47, 0, 0, 3, 6, 56
"/home/a/Coding/materiom/portal/src/Pages/Dashboard.js", "JavaScript", 0, 0, 78, 0, 0, 3, 5, 86
"/home/a/Coding/materiom/portal/src/Pages/EditRecipe.js", "JavaScript", 0, 0, 124, 0, 0, 12, 7, 143
"/home/a/Coding/materiom/portal/src/Pages/Login.js", "JavaScript", 0, 0, 76, 0, 0, 8, 6, 90
"/home/a/Coding/materiom/portal/src/Pages/NewRecipe.js", "JavaScript", 0, 0, 62, 0, 0, 3, 10, 75
"/home/a/Coding/materiom/portal/src/Pages/NotFound.js", "JavaScript", 0, 0, 7, 0, 0, 0, 1, 8
"/home/a/Coding/materiom/portal/src/Pages/PageTwo.js", "JavaScript", 0, 0, 29, 0, 0, 1, 5, 35
"/home/a/Coding/materiom/portal/src/Pages/Search.js", "JavaScript", 0, 0, 85, 0, 0, 4, 10, 99
"/home/a/Coding/materiom/portal/src/Pages/SubmissionConfirmation.js", "JavaScript", 0, 0, 27, 0, 0, 1, 2, 30
"/home/a/Coding/materiom/portal/src/Pages/Warning.js", "JavaScript", 0, 0, 82, 0, 0, 3, 4, 89
"/home/a/Coding/materiom/portal/src/Pages/YourRecipes.js", "JavaScript", 0, 0, 27, 0, 0, 4, 9, 40
"/home/a/Coding/materiom/portal/src/Tests/App.test.js", "JavaScript", 0, 0, 28, 0, 0, 12, 9, 49
"/home/a/Coding/materiom/portal/src/Tests/SideBar.test.js", "JavaScript", 0, 0, 22, 0, 0, 1, 4, 27
"/home/a/Coding/materiom/portal/src/index.css", "CSS", 0, 0, 0, 39, 0, 0, 10, 49
"/home/a/Coding/materiom/portal/src/index.js", "JavaScript", 0, 0, 10, 0, 0, 5, 3, 18
"/home/a/Coding/materiom/portal/src/reportWebVitals.js", "JavaScript", 0, 0, 12, 0, 0, 0, 2, 14
"/home/a/Coding/materiom/portal/src/setupTests.js", "JavaScript", 0, 0, 1, 0, 0, 4, 1, 6
"/home/a/Coding/materiom/portal/tailwind.config.js", "JavaScript", 0, 0, 19, 0, 0, 0, 1, 20
"Total", "-", 25772, 38, 1549, 39, 26, 126, 192, 27742